11111111111
10C0C0C0C01
1C1111111C1
101C0C00101
1C1E1110101
1011111C1C1
1C000000101
1C000000101
1C000000101
111111111P1
11111111111