1111111111111111111111111111111111
10000N000000N00C00000C000000N00001
1010010100100000101001000000010101
1010010010101010001001000000010101
1P0000000C00C00N000N000E0000N000C1
1111111111111111111111111111111111